########################################################################################S           
################################################################################# ########### ######
################################################################################# ########### ######
################################################################################# ########### ######
################################################################################# ########### ######
################################################################################# ########### ######
################################################################################# ########### ######
################################################################################# ########### ######
################################################################################# ########### ######
################################################################################# ########### ######
################################################################################# ########### ######
################################################################################# ########### ######
################################################################################# ########### ######
################################################################################# ########### ######
################################################################################# ########### ######
################################################################################# ########### ######
#################################################################################           # ######
#####################################################################################               
###############################               #############################################  #######
############################### ############# #############################################  #######
############################### ############# #############################################  #######
############################### ############# #############################################  #######
############################### ############# #############################################  #######
######                          ############# ######### ###################################  #######
###### ######################## ############# ######### ###################################  #######
###### ######################## ############# #########                                            #
###### ######################## ############# ######### ###################################  #######
###### ######################## ############# ######### ###################################  #######
###### ###################################### ######### ###################################  #######
###### ###################################### ######### ###################################  #######
###### ###################################### ######### ###################################  #######
###### ###################################### ######### ###################################  #######
###### ###################################### ######### ###################################  #######
###### ###################################### ######### ###################################  #######
###### ###################################### ######### #################                    #######
###### ######################################      #### ################# ################## #######
###### ###################################### #### #### ################# ################## #######
###### ###################################### #### #### ################# ##################        
###### ###################################### ####      ################# ######################### 
     # ###################################### ######### ################# ######################### 
#### # ###################################### ######### ################# ######################### 
#### # ###################################### ######### ################# ######################### 
#### # ###################################### ######### ################# ######################### 
       ###################################### ######### ################# ######################### 
#### ######################################## ######### ################# ######################### 
#### ######################################## ######### ################# ######################### 
#### ######################################## ######### ################# ##############            
#### ######################################## ########################### ############## ###########
#### ######################################## ########################### ############## ###########
#### #################################################################### ############## ###########
#### #################################################################### ############## ###########
#### #################################################################### ############## ###########
#### #################################################################### ############## ###########
#### #################################################################### ############## ########## 
#### #################################################                    ############## ########## 
#### ################################################# ################################# ########## 
#### ################################################# ################################# ########## 
#### ################################################# ################################# ########## 
#### ################################################# ################################# ########## 
####                                           ####### ################################# ########## 
############################################## ####### ################################# ########## 
############################################## ####### ################################# ########## 
############################################## ####### ################################# ########## 
############################################## ####### ################################# ########## 
############################################## ####### #################################            
##############################################                 ###################################  
###################################################### ####### ###################################  
###################################################### ####### ###################################  
###################################################### ####### ###################################  
###################################################### ####### ###################################  
###################################################### ####### ##############                       
###################################################### ####### ############## #################### #
###################################################### ####### ############## ###############       
###################################################### ####### ############## ##################### 
###################################################### ####### ############## ##################### 
###################################################### ####### ############## ##################### 
###################################################### ####### ############## ##################### 
###################################################### ####### ############## ##################### 
###################################################### ####### ############## ##################### 
###################################################### ####### ############## ####                  
###################################################### ####### ############## #### #################
###################################################### ####### ############## #### #################
###################################################### ####### ############## #### #################
###################################################### ####### ############## #### #################
###################################################### ####### ############## #### #################
###################################################### ####### ############## #### #################
###################################################### #######                #### #################
###################################################### ########################### #################
###################################################### ########################### #################
###################################################### ########################### #################
######################################################            ################ #################
#################################################################                         ##########
################################################################################## ###### ##########
################################################################################## ###### ##########
################################################################################## ###### ##########
################################################################################## ###### ##########
################################################################################## ###### ##########
################################################################################## ###### ##########
################################################################################## ###### ##########
##################################################################################E###### ##########
