##############################################################                         S############
############################################################## #################### ################
############################################################## #################### ################
############################################################## #################### ################
############################################################## ####################              ###
############################################################## ################################# ###
############################################################## ################################# ###
############################################################## ################################# ###
############################################################## ################################# ###
############################################################## ################################# ###
############################################################## ################################# ###
############################################################## ################################# ###
##############################################################       ########################### ###
################################################################ ############################### ###
################################################################ ############################### ###
################################################################ ############################### ###
################################################################ ############################### ###
################################################################ ############################### ###
################################################################ ############################### ###
################################################################ ############################### ###
################################################################ ############################### ###
################################################################ ############################### ###
################################################################ ############################### ###
################################################################ ###############################    
################################################################ ################################## 
################################################################ ################################## 
################################################################ ################################## 
################################################################ ################################## 
################################################################ ################################## 
################################################################ ################################## 
##################### ########################################## ################################## 
##################### ########################################## ################################## 
##################### ########################################## ################################## 
##################### ########################################## ################################## 
##################### ########################################## ################################## 
##################### ########################################## ################################## 
#####################        ################################### ################################## 
##################### ###### ################################### ################################## 
##################### ###### ##############             ######## ################################## 
##################### ###### ############## ########### ######## ################################## 
##################### ###### ############## ########### ######## ################################## 
##################### ###### ############## ########### ######## #########                          
##################### ###### ############## ########### ######## ######### ######################## 
##################### ###### ############## ########### ######## ######### ####################     
##################### ###### ############## ########### ######## ######### #################### ####
##################### ######                ########### ######## ######### #################### ####
##################### ################################# ######## ######### #################### ####
##################### ################################# ######## ######### #################### ####
##################### ################################# ######## ######### #################### ####
##################### ################################# ######## ######### #################### ####
##################### ################################# ######## ######### #################### ####
##################### ################################# ######## ######### #################### ####
##################### ################################# ######## ######### #################### ####
##################### ################################# #                  #################### ####
##################### ################################# # ################ #################### ####
#######               ################################# # ################ #################### ####
####### ############################################### # ################ #################### ####
####### ############################################### # ################ #################### ####
####### ############################################### # ################ #################### ####
####### #####################################                              #################### ####
####### #################################################### #############                          
####### ##############################                       ############# #########################
####### ############################## ################################### #########################
        ############################## ################################### #########################
###################################### ################################### #########################
###################################### ################################### #########################
###################################### ################################### #########################
###################################### ################################### #########################
###################################### ################################### #########################
###################################### ################################### #########################
###################################### ################################### #########################
###################################### ################################### #########################
###################################### ################################### #########################
###################################### ################################### #########################
###################################### ################################### #########################
                                       ################################### #########################
############ ############################################################# #########################
############ ############################################################# #########################
############ ############################################################# #########################
############ ############################################################# #########################
############ #################################################### ######## #########################
             #################################################### ######## #########################
 ############################################################              #########################
 ################################################################ ## ## ## #########################
 ################################################################ ## ## ## #########################
 ################################################################ ## ## ## #########################
 ################################################################ ## ## ## #########################
 ################################################################ ## ## ## #########################
 ################################################################ ## ## ## #########################
 ################################################################ ## ## ## #########################
 ############################## ################################# ## ## ## #########################
 ############################## ################# ############### ## ## ## #########################
 ############################## ################# ############### ## ## ## #########################
 ############################## ################# ############### ## ## ## #########################
 ############################## ################# ############### ## ## ## #########################
 ############################## ################# ############### ## ## ## #########################
 ##############################                   ############### ## ## ## #########################
 ############################## #################                 ## ## ## #########################
 ############################## ################################# ## ## ## #########################
E                               #################################       ##                         #
