##########        ######################
##########    ##########################
############# ##########################
############# ##########################
############# ##########################
############# ##########################
              ##########################
 #######################################
E   ####################################
        ################################
###             ########################
### ### ####### ###############         
### ###########         ####### ####### 
### ################### ####### #######S
### ###################         ########
    ########################### ########
 ############################## ########
 #######################################
 #######################################
 #######################################
 #######################################
 #######################################
        ################################
####### ################################
####### ################################
