####################################################################################################
#############################                               ########################################
#############################                               ########################################
#########   #  ###############                              ########################################
########       #####  ########                            ##########################################
#######        ####   #######                             ##########################################
########              ###  ##                    ##       ##########################################
#########            ##                               #   ##########################################
###########          ##                              ### ###########################################
##########           #                      #          #############################################
########                                  #####        #############################################
#######      #       #                   #######       #############################################
#  ###      ##        #                  ########       ############################################
#       #    ##                           ##########   #############################################
#S              #                         ##########  ##############################################
#                                           ######## ###############################################
#           #                               ########################################################
#                                         ##########################################################
#                 #       # #            ###########################################################
#                        ###      ##################################################################
#                        ####    ###################################################################
#                        ##### #####################################################################
#                        ###########################################################################
#                           ########################################################################
###                     #   ########################################################################
###                    ##   ########################################################################
###             #      #    ########################################################################
###  #       ####      #    ########################################################################
#   #                        #######################################################################
#                           ########################################################################
#  #                       ##############################################  #########################
# #                        ###########################################     #########################
#                #         ###########################################      ########################
#              ##         #############################################     ########################
#                         #############################################   # ########################
#             #           ############################################   ###########################
#                         ##########################################     ###########################
#                         ##########################################     ###########################
##                         #########################################       #########################
#                    ## #  #####################################           #########################
#                    ##### #####################################          ##########################
#                   ###################################    ####           ##########################
#                      ###  #######################                      ###########################
#                      ##   #######################  #  ##  ##           ###########################
#                            #####   #############  ##############       ###########################
#                            #  #    ##############   ###########   ##   ###########################
#                           ##           #########  #  #####  ##    #     ##########################
#                           #            #   ####   #      #              ##########################
#                                             ###              # #         #########################
#                                             ####   # #    ##       #      ########################
#                                             ####   ########        ##  #  ########################
#                                             ###     #######       ###  #    ######################
#                                            ##       ### #    #    ####      ######################
#                                           ####             ##     ####  #  #######################
#                                          #               #####  # ###      #######################
#                                              ##         ##############    #######     ############
#                                               #         ##############      ####      ############
#                                                          ###############     ##     ##############
##                                                #        ###############     ##     ##############
#          # #                                    #         ############               #############
#                                                #          ############                 ###########
#                                                          ##############  #             ###########
#  #                                                       ##############                ###########
#                                                          ###############               ###########
#                #           ##     #     #                ##################            ###########
#                                 #                         ################             ###########
#                              # ##                       # ###############              ###########
#                                ##                       #################     ##    #   ##########
#                              #           #              #################      ##  ###   #########
#                                    #      #              ##################   #########  #########
#                                    #       #             #####    #####################  #########
#                                    #                     #####     ####################   ########
#                                   #                        #       ######################  #######
#                                                                    #######################   #####
#                                                                   ########################## #####
#                                                                 ##########################     ###
#                                                        #####     ###################           ###
#                                                                  ###################           ###
#                                                             #   ####################      #     ##
##                        #   #                               #   ############                #   ##
#######                   ## ###                #             #  ############                 #   ##
########                #   #                 ##                 ############                    ###
###                         #                ##                 #############                     ##
###                                         ###                   ############                    E#
###                                           #        #          ############                     #
####                             #   ##                ##        ################              #####
######                        #  #########    #     ######  #####################              #####
#####                              #########  ##    ###############################            #####
####                                ########  #   #####################################      #######
###                             ##  ########    ####################################         #######
##                             ###  ########    #####################################        #######
#                                    #  #####   ######################################  #    #######
#                          # #          ##############################################      ########
#                          ####      # ##############################################       ########
#                         ######    #################################################       ########
#                          #####   ###################################################     #########
#                          #####   ###################################################    ##########
#                      #  ######   #################################################################
#              #       #  ######   #################################################################
####################################################################################################
