##########
#####S ###
#####  ###
#####   ##
#####    #
#######  #
######## #
######## #
########E#
##########
