####################################################################################################
#########         ##################################################################################
########            ################################################################################
#######               ##############################################################################
######      #         ##############################################################################
#####       #         ##############################################################################
#        ##           ##############################################################################
#                   #  #############################################################################
#                    #  ############################################################################
#          #         #  ############################################################################
#        ###            ############################################################################
#         #  #          ############################################################################
#            ## #   #  #############################################################################
#                    ###############################################################################
#                     ##############################################################################
#               ##     #############################################################################
#                #      ############################################################################
#                      #############################################################################
#                      #############################################################################
#                      #############################################################################
#                      #############################################################################
#                       ############################################################################
#                 #        #########################################################################
#                          #########################################################################
#                         ##########################################################################
#               #   #   ############################################################################
#                  ##   ############################################################################
#                 ##### ############################################################################
#                ##############################################################  ###################
#                ###     #####################################################     #################
#                ###       ##################################################      #################
#                 #        ##################################################     ##################
#           #            # ###################################################   ###################
#                       ####################   ###############################    ##########    ####
#                       ####################    ###############################    ##########     ##
#                       #####################    ##############################  #  ####          ##
#                        ##################      ##############################     ###            #
#                      #  ################     # ###############################    ##  ##     ## E#
#                           #########  ###     ###############################         #####   #####
#                             #######         ##############################          ######## #####
##                             ######   #    ##############################        #################
###                                ##   ##   #################  #  ####### #       ####  ###########
#####                                 #      #################     ####    ## #   ####    ##########
#######                               ##      ################      ##     ###     #  #   ##########
######                              #      #  #################            ####           ##########
######                              #      ##  ########### #####           ####      #     #########
#  ##                                  ######  ###########  #####            ##     ###    #########
#                                      #####   ##########    #####            #   #####   ##########
#              #       #             #######   #########      ##                   ##   ############
##             ##   ##              ########  ###########                          #     ###########
###           ####  #    #          ######   ############                          ## #  ###########
####         ##         ##          #####    ############          #                  ##############
#  ##                #####         ##          ###########                           ###############
#               #    ####         ###          ############                           ##############
#             #     #####    #   ##            ####  #####                ###  #       #############
#       ##  ###     ######   #       #         ###    ####               ###           #############
#        ## ##      ####             #              #  ###                  #         ##############
#        #####      ####                               ###                           ###############
#       #######     ####                           # #####           ##      # #     ###############
#      ##########   ####                       #  ########  #        #        ###   ################
#      #####   ###  ###                       ###############       ###       ###   ################
#      ##      ### #####                      ##############        #        ######  ###############
#      #       ##  #####                      ###############       #      #######   ###############
#              ##  ###                       ################             ########  ################
#              ##   #                          ###############   #           #####   ###############
#              ##   ##                         ###############   #                     #############
#     #            ####                       ################ ##  #                   #############
#                   ######                   #############                          ################
#                   #   ######        #       ############                          ################
#                #      ######       ##       #############   ##                    ################
#                 #      ######     ###       #################    #                ################
#                     #  ####### #######       ###############                     #################
#                        ###############        ##############             #        ################
#                          #################      ##############      #             ################
#                     #     ################    #   ########  ##                    ################
#                     #  #  ########  ######   ##  ########                        #################
#                        #  #######    #####          ####                #         ################
#                         #  #####     #####          ####                           ###############
#                  #         ###                                                     ###############
#                        ##  ####                                                   ################
#                        #                                                         #################
#                                                                                #   #  ############
#                                                                               ###       ##########
#                          ##                                                   ##        ##########
#                     ##   #                            ###                              ###########
#                   ##               ##                 ####                              ##########
#                                    #      ##          ##                               ###  ######
#                       #                    # #       ###                               ##   ######
#                                             ####  #  ####                                  #######
#                                              #############                            #    #######
#                                              ############                                  #######
#                               #              ##  ########                               # ########
#S                #                            ##  #######                  #               ########
#                                                  #######                ###               ########
#                                     ###          #####  #                ##               ########
#                                    ####              #                   ##                  #####
#                                   ######                                 ##                  #####
#                             #    #######                                                     #####
#                             ## ###########          #                     #                  #####
####################################################################################################
