####################
#############     E#
############  #    #
############  ##   #
#############  ##  #
##############  ####
###############  ###
##############   ###
##############S  ###
####################
