##############################
######################E ######
######################  ######
######################  ######
#####################   ######
######################  ######
######################  ######
######################  ######
#######################S######
##############################
