####################################################################################################
################################E ##################################################################
################################                         ###########################################
################################                         ###########################################
################################                         ###########################################
#################################                            #######################################
###################################                          #######################################
###############################  ###                     #   #######################################
################################                            ########################################
################################                  #         ########################################
################################                ###         ########################################
################################              #  #         #########################################
################################            #               ########################################
#################################                           ########################################
##################################                         #########################################
#################################        # ##              #########################################
#################################           ## #           #########################################
#################################           #####          #########################################
#################################             ###         ##########################################
##################################     #       #          ##########################################
##################################      #           #     ##########################################
#################################        #          ##    ##########################################
###########################    #         ##      ####   ############################################
############################        #    ##      #####  ############################################
##########################          ##   ###    ######   ###########################################
##########################   #           #####  ##          ########################################
########################                 ####   #           ########################################
########################  #              ####               ########################################
########################                ######            ##########################################
#######################     ##          ###########       ##########################################
#######################     #  #     ##############       ##########################################
#######################  #    ### ##################### ############################################
#####################         ######################################################################
####################         #######################################################################
####################  #      #######################################################################
####################  ##############################################################################
###################  ###############################################################################
##################   ###############################################################################
###################S################################################################################
####################################################################################################
