####################################################################################################
#############S #####################################################################################
#                 #          ##########       ######################################################
#                            ########        #######################################################
#                            ####     #      #######################################################
#                   ###     #  ##     #      #######################################################
#                    ####      #             #######################################################
#                     #                    #########################################################
#                                 #        #########################################################
#                          #      ### ## ###########################################################
#                                 ##################################################################
#                                 ##################################################################
#                                  #################################################################
#                      #            ################################################################
#                                   ################################################################
#                       ####      ##################################################################
#                        ###      ##################################################################
#             #           ##    ####################################################################
#                          #  ######################################################################
#                             ######################################################################
#        #       ##           ######################################################################
#        #   #   #            ######################################################################
#       #    # #              ######################################################################
#      ###      #              #####################################################################
#       ##     #       #       #####################################################################
#       ###          ###       #####################################################################
#      #####        ####      ######################################################################
#     ######         #####     #####################################################################
#       ####         ####       ####################################################################
#       ######### # #####        ###################################################################
#      ###################       ###################################################################
#    #######################     ###################################################################
#  ######################### #  ####################################################################
#  ###########################   ###################################################################
#  ##########################    ###################################################################
#  #########################    ####################################################################
###########################    #####################################################################
###########################  #######################################################################
############################E#######################################################################
####################################################################################################
