####################################################################################################
#       #     #######  ####################       ############################# S                  #
#        #    #######     #####  #######         ##############################                    #
#             #######     #####  ####          #  ##############################                   #
#             ###     #  #                ###  #  ##############################                 # #
#            ###   ####                   ##   ## ###############################              # ###
#              #   ##                     ##   #    ########################   ##              #####
#                  #          ##           ## ###      #####  #############    ###           #######
#                 ###         ##               #        ####    ###########     ####         #######
#             #######         ##      ###    #                  ############    ####     ##   ######
#              ######     #   ######                   #  ##  ###############    #####           ###
###            #######    ###########             #   #####  #################                #    #
###         #    ######   ############               ######  ##################              ###   #
##          #    ######  #########   #               ######     ###############               #    #
###   ##     # #   #####   ########               # ######## #   ##############                #   #
###   #      ##    ##  #   ########               ##############  #    ####   ##            ## #   #
########     ###   #       #########                ############          #   #            ###     #
##  #####    ####            ######                  #########           #                  ##     #
##   ###     ####             ####                   #########                       #             #
#    ##    #########           ###  ###              ########                                      #
#     #     #######             #  #####             #######                 #           #  #    # #
#     #     ########     # #      #####           # ########             #         ##   #        # #
#              ##### #       #   #######            #########            ##      # ######       ####
#              ########       #  ########           ##########    ##     ######  ############ ######
#             ##########      #############         #########      #################################
#            ######    #        ###########       ##########       #################################
#            #######            ############     ############      #################################
#           #####   #      ##################################    ###################################
#             ###          ##################################   ####################################
#    #   #            #    #########################################################################
#                     ##  ##########################################################################
##            ##  #      ###########################################################################
##            ### ###      #########################################################################
#             ###        #  ########################################################################
#             ##             #######################################################################
#                       #    #######################################################################
#            #              ########################################################################
#                  #        ########################################################################
#                   ## # #   #######################################################################
##   #        #     ######   #######################################################################
####    ##        #######    #######################################################################
####   #### #    #########       ###################################################################
##     ####### ##########        ###################################################################
#    #####################  #    ###################################################################
##   #########################  ####################################################################
#############################     ##################################################################
#############################     ##################################################################
############################# ### ##################################################################
#############################E######################################################################
####################################################################################################
