###########                 ###################                                         ############
########### ###############       ############# ####################################### ###         
########### #                      ############ ####################################### ########### 
########### ########## #### ################### #######################################             
########### ########## #### ################### ################################################### 
########### ########## #### ################### ################################################### 
########### ########## #### ################### ###############     ############################### 
########### ##########                ######### ############### ### ############################### 
########### ############### #### ############## ############### ### ############################### 
########### ############### #### ############## ############### ###                 ############### 
########### ############### #### ############## ############### ################### ############### 
########### ############### #### ## ########### ############### ################### ############### 
########### ############### #### ## ########### ############### ################### ############### 
########### ############### #### ##             ############### ################### ############### 
########### ############### #### ## ########################### ################### ############### 
########### ############### #### ## ########################### ################### ############### 
########### ############### #### ## ########################### ################### ############### 
            ############### #### ## ########################### ################### ############### 
########################### #### ## ########################### ################### ###########     
#######################                     ################### ###################                 
####################### ###         ####### ################### ################### ##########      
####################### ### #### ##########                     ################### ######     #### 
####################### ### #### ############################## ################### ###### ######## 
####################### ### #### ############################## ################### ###### ######## 
############                     ################################################## ###### ######## 
############ ########## ### ####################################################### ###### ######## 
############ ########## ########################################################### ######    ##### 
############ ########## ###########################################################                 
############ ########## ##################################################################### ##### 
                ####### ##################################################################### ##### 
############### ####### ##################################################################### ##### 
############### ####### ##################################################################### ##### 
############### ####### ##################################################################### ##### 
############### ####### ##################################################################### ##### 
############### ####### ##################################################################### ##### 
############### ####### ##################################################################### ######
############### ####### ##################################################################### ######
############### ####### ##################################################################### ######
###############            ################################################################## ######
###                     ## ################################################################## ######
### ################### ## ################################################################## ######
### ################### ## ################################################################## ######
### ################### ## ################################################################## ######
### ################### ##           ########################################################       
### ################### ############ ############################################################## 
### ################### ############ ############################################################## 
### ################################ ############################################################## 
### ################################ ############################################################## 
    ################################ ############################################################## 
#################################### ############################################################## 
#################################### ############################################################## 
#################################### ############################################################## 
#################################### ############################################################## 
#################################### ############################################################## 
#################################### ############################################################## 
#################################### ############################################################## 
#################################### ############################################################## 
#################################### ############################################################## 
#################################### ############################################################## 
#################################### ############################################################## 
#################################### ############################################################## 
#################################### ##################################################             
#################################### ################################################## ############
#################################### ################################################## ############
#################################### ################################################## ############
#################################### ################################################## ############
#################################### ################################################## ############
#################################### ################################################## ############
#################################### ################################################## ############
####################################                    ############################### ############
####################################################### ############################### ############
####################################################### ############################### ############
####################################################### ############################### ############
####################################################### ############################### ############
#######################################################                       ######### ############
############################################################# #####################                S
############################################################# ##################### ### ############
############################################################# ##################### ### ############
############################################################# #############                         
############################################################# ##################### ########## #####
############################################################# ##################### ########## #####
############################################################# ##################### ########## #####
############################################################# ##################### ########## #####
################################################                 ################## ########## #####
################################################ ################################## ########## #####
###############################             #### ################################## ########## #####
############################### ########### #### ##############                     ########## #####
############################### ########### #### ############## ################### ########## #####
############################### ########### #### ############## ################### ########## #####
############################### ########### #### ############## ################### ########## #####
############################### ########### #### ############## ################### ########## #####
############################### ###########                     ################### ########## #####
###########                     ################ ################################## ########## #####
########### ################### ################ ############################################# #####
########### ################### ################ ############################################# #####
########### #################################### #########################                     #####
########### #################################### #################         #########################
E           #################################### ################# #################################
########### #################################### ################# #################################
########### #################################### ################# #################################
